"aa" = (/turf/space,/area/space)
"ab" = (/turf/simulated/wall/r_wall,/area/om_ships/caelum)
"ac" = (/turf/simulated/floor/airless/ceiling,/area/om_ships/caelum)
"ad" = (/turf/simulated/floor/airless,/area/om_ships/caelum)
"ae" = (/obj/machinery/button{id = 2; pixel_y = 32},/turf/simulated/floor/airless/ceiling,/area/om_ships/caelum)
"af" = (/obj/structure/ore_box,/turf/simulated/floor/airless/ceiling,/area/om_ships/caelum)
"ag" = (/obj/random,/obj/structure/largecrate,/turf/simulated/floor/airless/ceiling,/area/om_ships/caelum)
"ah" = (/obj/structure/barrel,/turf/simulated/floor/airless/ceiling,/area/om_ships/caelum)
"ai" = (/obj/random/ammo,/obj/structure/largecrate,/turf/simulated/floor/airless/ceiling,/area/om_ships/caelum)
"aj" = (/obj/random/handgun,/obj/structure/largecrate,/turf/simulated/floor/airless/ceiling,/area/om_ships/caelum)
"ak" = (/obj/structure/reagent_dispensers/fueltank,/turf/simulated/floor/airless/ceiling,/area/om_ships/caelum)
"al" = (/obj/structure/reagent_dispensers/coolanttank,/turf/simulated/floor/airless/ceiling,/area/om_ships/caelum)
"am" = (/obj/random/toolbox,/turf/simulated/floor/airless/ceiling,/area/om_ships/caelum)
"an" = (/obj/item/robot_parts/l_leg,/obj/structure/largecrate,/turf/simulated/floor/airless/ceiling,/area/om_ships/caelum)
"ao" = (/obj/item/robot_parts/chest,/obj/structure/largecrate,/turf/simulated/floor/airless/ceiling,/area/om_ships/caelum)
"ap" = (/obj/item/robot_parts/r_arm,/obj/structure/largecrate,/turf/simulated/floor/airless/ceiling,/area/om_ships/caelum)
"aq" = (/obj/structure/closet/crate/secure/loot,/turf/simulated/floor/airless/ceiling,/area/om_ships/caelum)
"ar" = (/obj/machinery/power/apc{cell_type = /obj/item/weapon/cell/infinite; pixel_y = 32},/turf/simulated/floor/airless/ceiling,/area/om_ships/caelum)
"as" = (/obj/machinery/door/blast/regular,/turf/simulated/floor/airless,/area/om_ships/caelum)
"at" = (/obj/random/cash,/obj/structure/largecrate,/turf/simulated/floor/airless/ceiling,/area/om_ships/caelum)
"au" = (/obj/random/smokes,/obj/structure/largecrate,/turf/simulated/floor/airless/ceiling,/area/om_ships/caelum)
"av" = (/obj/structure/reagent_dispensers/watertank,/turf/simulated/floor/airless/ceiling,/area/om_ships/caelum)
"aw" = (/obj/item/robot_parts/robot_suit,/obj/structure/largecrate,/turf/simulated/floor/airless/ceiling,/area/om_ships/caelum)
"ax" = (/obj/item/robot_parts/head,/obj/structure/largecrate,/turf/simulated/floor/airless/ceiling,/area/om_ships/caelum)
"ay" = (/obj/random,/obj/random,/obj/structure/largecrate,/turf/simulated/floor/airless/ceiling,/area/om_ships/caelum)
"az" = (/obj/machinery/door/blast/regular{id = 2},/turf/simulated/floor/airless,/area/om_ships/caelum)
"aA" = (/obj/random/ammo,/obj/random/smokes,/obj/structure/largecrate,/turf/simulated/floor/airless/ceiling,/area/om_ships/caelum)
"aB" = (/obj/machinery/atmospherics/pipe/tank/phoron{tag = "icon-phoron_map (EAST)"; icon_state = "phoron_map"; dir = 4},/turf/simulated/floor/plating,/area/om_ships/caelum)
"aC" = (/obj/structure/window/reinforced/treated{tag = "icon-rwindow (EAST)"; icon_state = "rwindow"; dir = 4},/obj/machinery/atmospherics/pipe/simple/visible/fuel{tag = "icon-intact (EAST)"; icon_state = "intact"; dir = 4},/turf/simulated/floor/plating,/area/om_ships/caelum)
"aD" = (/obj/machinery/atmospherics/unary/engine{tag = "icon-nozzle (WEST)"; icon_state = "nozzle"; dir = 8},/turf/space,/area/om_ships/caelum)
"aE" = (/obj/effect/decal/warning_stripes,/turf/simulated/floor/airless/ceiling,/area/om_ships/caelum)
"aF" = (/obj/structure/closet/secure_closet/engineering_personal,/turf/simulated/floor/tiled,/area/om_ships/caelum)
"aG" = (/obj/machinery/light{dir = 1},/obj/item/weapon/storage/toolbox/mechanical,/obj/structure/table/steel,/turf/simulated/floor/tiled,/area/om_ships/caelum)
"aH" = (/obj/structure/table/steel,/obj/random/snack,/turf/simulated/floor/tiled,/area/om_ships/caelum)
"aI" = (/obj/machinery/power/apc{cell_type = /obj/item/weapon/cell/infinite; pixel_y = 32},/obj/structure/toilet,/turf/simulated/floor/tiled,/area/om_ships/caelum)
"aJ" = (/obj/structure/closet/crate/freezer/rations,/turf/simulated/floor/tiled,/area/om_ships/caelum)
"aK" = (/obj/machinery/atmospherics/pipe/tank/phoron{tag = "icon-phoron_map (EAST)"; icon_state = "phoron_map"; dir = 4},/obj/machinery/light{dir = 8; icon_state = "tube1"; pixel_y = 0},/turf/simulated/floor/plating,/area/om_ships/caelum)
"aL" = (/obj/docking_umbilical/east{name = "Container Umbilical"},/turf/simulated/floor/airless/ceiling,/area/om_ships/caelum)
"aM" = (/obj/random/projectile,/obj/structure/largecrate,/turf/simulated/floor/airless/ceiling,/area/om_ships/caelum)
"aN" = (/obj/structure/closet/crate/secure/gear,/obj/random/gloves,/obj/random/shoes,/turf/simulated/floor/airless/ceiling,/area/om_ships/caelum)
"aO" = (/obj/structure/reagent_dispensers/beerkeg,/turf/simulated/floor/airless/ceiling,/area/om_ships/caelum)
"aP" = (/obj/structure/grille,/turf/space,/area/om_ships/caelum)
"aQ" = (/obj/machinery/atmospherics/pipe/vent,/obj/machinery/atmospherics/pipe/simple/hidden/supply,/obj/machinery/embedded_controller/radio/airlock/airlock_controller{pixel_y = 32},/turf/simulated/floor/plating,/area/om_ships/caelum)
"aR" = (/obj/machinery/atmospherics/portables_connector,/obj/machinery/atmospherics/pipe/simple/hidden/supply,/obj/machinery/portable_atmospherics/canister/air/airlock{anchored = 1},/turf/simulated/floor/plating,/area/om_ships/caelum)
"aS" = (/obj/machinery/alarm{pixel_y = 32},/turf/simulated/floor/tiled,/area/om_ships/caelum)
"aT" = (/obj/machinery/light{icon_state = "tube1"; dir = 4},/obj/structure/closet/walllocker/emerglocker/north,/turf/simulated/floor/tiled,/area/om_ships/caelum)
"aU" = (/turf/simulated/wall,/area/om_ships/caelum)
"aV" = (/turf/simulated/floor/tiled,/area/om_ships/caelum)
"aW" = (/obj/machinery/light{icon_state = "tube1"; dir = 4},/turf/simulated/floor/tiled,/area/om_ships/caelum)
"aX" = (/obj/structure/window/reinforced/treated{tag = "icon-rwindow (EAST)"; icon_state = "rwindow"; dir = 4},/turf/simulated/floor/plating,/area/om_ships/caelum)
"aY" = (/obj/machinery/light/invis,/turf/simulated/floor/airless/ceiling,/area/om_ships/caelum)
"aZ" = (/obj/machinery/door/airlock/external,/turf/simulated/floor/airless,/area/om_ships/caelum)
"ba" = (/obj/structure/lattice,/turf/space,/area/om_ships/caelum)
"bb" = (/obj/machinery/door/airlock/glass_external,/turf/simulated/floor/plating,/area/om_ships/caelum)
"bc" = (/obj/machinery/atmospherics/pipe/simple/hidden/supply{dir = 5},/turf/simulated/floor/plating,/area/om_ships/caelum)
"bd" = (/obj/machinery/atmospherics/pipe/simple/hidden/supply{dir = 9},/turf/simulated/floor/plating,/area/om_ships/caelum)
"be" = (/obj/machinery/door/airlock/external,/obj/machinery/door/firedoor,/turf/simulated/floor/plating,/area/om_ships/caelum)
"bf" = (/obj/machinery/door/airlock,/obj/machinery/door/firedoor,/turf/simulated/floor/tiled,/area/om_ships/caelum)
"bg" = (/obj/machinery/portable_atmospherics/canister/air{anchored = 1},/turf/simulated/floor/tiled,/area/om_ships/caelum)
"bh" = (/obj/structure/grille,/turf/simulated/floor/airless/ceiling,/area/om_ships/caelum)
"bi" = (/obj/effect/decal/warning_stripes,/obj/machinery/button{id = 2; pixel_x = 32},/turf/simulated/floor/airless/ceiling,/area/om_ships/caelum)
"bj" = (/obj/random/ammo,/obj/random/ammo,/obj/structure/largecrate,/turf/simulated/floor/airless/ceiling,/area/om_ships/caelum)
"bk" = (/obj/structure/janitorialcart,/turf/simulated/floor/airless/ceiling,/area/om_ships/caelum)
"bl" = (/obj/machinery/light{dir = 8; icon_state = "tube1"; pixel_y = 0},/turf/simulated/floor/plating,/area/om_ships/caelum)
"bm" = (/turf/simulated/floor/plating,/area/om_ships/caelum)
"bn" = (/obj/machinery/computer/station_alert,/turf/simulated/floor/tiled,/area/om_ships/caelum)
"bo" = (/obj/machinery/computer/power_monitor,/turf/simulated/floor/tiled,/area/om_ships/caelum)
"bp" = (/obj/item/modular_computer/console,/turf/simulated/floor/airless/ceiling,/area/om_ships/caelum)
"bq" = (/obj/machinery/light/small{dir = 4; pixel_y = 8},/turf/simulated/floor/airless/ceiling,/area/om_ships/caelum)
"br" = (/obj/machinery/door/airlock/halo_maint,/turf/simulated/floor/airless/ceiling,/area/om_ships/caelum)
"bs" = (/obj/machinery/door/airlock/multi_tile/halo/blast,/turf/simulated/floor/airless/ceiling,/area/om_ships/caelum)
"bt" = (/turf/space,/area/om_ships/caelum)
"bu" = (/obj/machinery/door/airlock/glass_external,/obj/machinery/door/firedoor,/turf/simulated/floor/tiled,/area/om_ships/caelum)
"bv" = (/obj/machinery/computer/navigation,/turf/simulated/floor/tiled,/area/om_ships/caelum)
"bw" = (/obj/structure/bed/chair{dir = 8},/turf/simulated/floor/tiled,/area/om_ships/caelum)
"bx" = (/obj/effect/decal/warning_stripes,/obj/machinery/button{id = 1; pixel_x = 32},/turf/simulated/floor/airless/ceiling,/area/om_ships/caelum)
"by" = (/obj/random/drinkbottle,/obj/random/drinkbottle,/obj/structure/largecrate,/turf/simulated/floor/airless/ceiling,/area/om_ships/caelum)
"bz" = (/obj/random/plushie,/obj/structure/largecrate,/turf/simulated/floor/airless/ceiling,/area/om_ships/caelum)
"bA" = (/obj/random/contraband,/obj/structure/largecrate,/turf/simulated/floor/airless/ceiling,/area/om_ships/caelum)
"bB" = (/obj/structure/closet/crate/large/hydroponics,/turf/simulated/floor/airless/ceiling,/area/om_ships/caelum)
"bC" = (/obj/random/tool,/turf/simulated/floor/airless/ceiling,/area/om_ships/caelum)
"bD" = (/obj/machinery/light{dir = 8; icon_state = "tube1"; pixel_y = 0},/obj/machinery/atmospherics/pipe/vent,/obj/machinery/atmospherics/pipe/simple/hidden/supply,/turf/simulated/floor/plating,/area/om_ships/caelum)
"bE" = (/obj/machinery/computer/helm,/turf/simulated/floor/tiled,/area/om_ships/caelum)
"bF" = (/obj/machinery/computer/engines,/turf/simulated/floor/tiled,/area/om_ships/caelum)
"bG" = (/obj/machinery/door/airlock/external,/turf/simulated/floor/plating,/area/om_ships/caelum)
"bH" = (/obj/machinery/embedded_controller/radio/airlock/airlock_controller{pixel_y = -32},/turf/simulated/floor/plating,/area/om_ships/caelum)
"bI" = (/obj/machinery/alarm{pixel_y = -32},/turf/simulated/floor/tiled,/area/om_ships/caelum)
"bJ" = (/obj/machinery/light{icon_state = "tube1"; dir = 4},/obj/structure/closet/walllocker/emerglocker/south,/turf/simulated/floor/tiled,/area/om_ships/caelum)
"bK" = (/obj/structure/curtain,/turf/simulated/floor/tiled,/area/om_ships/caelum)
"bL" = (/obj/machinery/light{icon_state = "tube1"; dir = 4},/obj/structure/table/steel,/obj/structure/closet/medical_wall/filled{pixel_x = 24},/turf/simulated/floor/tiled,/area/om_ships/caelum)
"bM" = (/obj/effect/decal/warning_stripes,/turf/simulated/floor/airless,/area/om_ships/caelum)
"bN" = (/obj/structure/bed,/obj/item/weapon/bedsheet,/obj/structure/oxy_dispenser/large{pixel_y = -32},/turf/simulated/floor/tiled,/area/om_ships/caelum)
"bO" = (/obj/machinery/light,/obj/structure/curtain,/turf/simulated/floor/tiled,/area/om_ships/caelum)
"bP" = (/obj/structure/closet/wardrobe,/obj/item/clothing/under/frontier,/obj/random/shoes,/obj/random/shoes,/obj/item/clothing/under/serviceoveralls,/obj/item/clothing/under/confederacy,/obj/random/gloves,/obj/random/handgun,/turf/simulated/floor/tiled,/area/om_ships/caelum)
"bQ" = (/obj/machinery/vending/wallmed1{pixel_x = 28},/obj/structure/table/steel,/obj/random/firstaid,/turf/simulated/floor/tiled,/area/om_ships/caelum)
"bR" = (/obj/docking_umbilical/east{name = "Cargo Umbilical"},/turf/simulated/floor/airless,/area/om_ships/caelum)
"bS" = (/obj/machinery/door/blast/regular,/turf/simulated/floor/airless/ceiling,/area/om_ships/caelum)
"bT" = (/obj/structure/ore_box,/turf/simulated/floor/airless,/area/om_ships/caelum)
"bU" = (/obj/random/hat,/obj/random/shoes,/obj/structure/largecrate,/turf/simulated/floor/airless/ceiling,/area/om_ships/caelum)
"bV" = (/obj/random/clothing,/obj/random/shoes,/obj/random/masks,/obj/random/gloves,/obj/structure/largecrate,/turf/simulated/floor/airless/ceiling,/area/om_ships/caelum)
"bW" = (/obj/item/pizzabox/meat,/obj/item/pizzabox/mushroom,/turf/simulated/floor/airless/ceiling,/area/om_ships/caelum)
"bX" = (/obj/item/pizzabox/margherita,/turf/simulated/floor/airless/ceiling,/area/om_ships/caelum)
"bY" = (/obj/item/pizzabox/meat,/obj/item/pizzabox/margherita,/turf/simulated/floor/airless/ceiling,/area/om_ships/caelum)
"bZ" = (/obj/structure/closet/crate/secure/weapon,/obj/random/handgun,/turf/simulated/floor/airless/ceiling,/area/om_ships/caelum)
"ca" = (/obj/item/pizzabox/mushroom,/obj/item/pizzabox/mushroom,/obj/item/pizzabox/vegetable,/turf/simulated/floor/airless/ceiling,/area/om_ships/caelum)
"cb" = (/obj/item/pizzabox/meat,/obj/item/pizzabox/vegetable,/obj/item/pizzabox/vegetable,/turf/simulated/floor/airless/ceiling,/area/om_ships/caelum)
"cc" = (/obj/item/pizzabox/margherita,/obj/item/pizzabox/margherita,/obj/item/pizzabox/vegetable,/turf/simulated/floor/airless/ceiling,/area/om_ships/caelum)
"cd" = (/obj/random/firstaid,/obj/structure/largecrate,/turf/simulated/floor/airless/ceiling,/area/om_ships/caelum)
"ce" = (/obj/structure/closet/crate/secure/weapon,/obj/random/ammo,/turf/simulated/floor/airless/ceiling,/area/om_ships/caelum)
"cf" = (/obj/machinery/button{id = 1; pixel_y = -32},/turf/simulated/floor/airless/ceiling,/area/om_ships/caelum)
"cg" = (/obj/random/storage,/obj/structure/largecrate,/turf/simulated/floor/airless/ceiling,/area/om_ships/caelum)
"ch" = (/obj/random/tool,/obj/structure/largecrate,/turf/simulated/floor/airless/ceiling,/area/om_ships/caelum)
"ci" = (/obj/item/pizzabox/meat,/obj/item/pizzabox/meat,/turf/simulated/floor/airless/ceiling,/area/om_ships/caelum)
"cj" = (/obj/item/pizzabox/mushroom,/obj/item/pizzabox/margherita,/turf/simulated/floor/airless/ceiling,/area/om_ships/caelum)
"ck" = (/obj/item/pizzabox/meat,/obj/item/pizzabox/margherita,/obj/item/pizzabox/vegetable,/turf/simulated/floor/airless/ceiling,/area/om_ships/caelum)

(1,1,1) = {"
aaaaaaaaaaaaaaaaaaaaaaaaaaaaaaaaaaaaaaaaaaaaaaaaaaaaaaaaaaaaaaaaaaaaaaaaaaaaaaaaaaaaaaaaaaaaaaaaaaaaaaaaaaaaaaaaaaaaaaaaaaaaaaaaaaaaaaaaaaaaaaaaaaaaaa
aaaaaaaaaaaaaaaaaaaaaaaaaaaaaaaaaaaaaaaaaaaaaaaaaaaaaaaaaaaaaaaaaaaaaaaaaaaaaaaaaaaaaaaaaaaaaaaaaaaaaaaaaaaaaaaaaaaaaaaaaaaaaaaaaaaaaaaaaaaaaaaaaaaaaa
aaaaaaaaaaaaaaaaaaaaaaaaaaaaaaaaaaaaaaaaaaaaaaaaaaaaaaaaaaaaaaaaaaaaaaaaaaaaaaaaaaaaaaaaaaaaaaaaaaaaaaaaaaaaaaaaaaaaaaaaaaaaaaaaaaaaaaaaaaaaaaaaaaaaaa
aaaaaaaaaaaaaaaaaaaaaaaaaaaaaaaaaaaaaaaaaaaaaaaaaaaaaaaaaaaaaaaaaaaaaaaaaaaaaaaaaaaaaaaaaaaaaaaaaaaaaaaaaaaaaaaaaaaaaaaaaaaaaaaaaaaaaaaaaaaaaaaaaaaaaa
aaaaaaaaaaaaaaaaaaaaaaaaaaaaaaaaaaaaaaaaaaaaaaaaaaaaaaaaaaaaaaaaaaaaaaaaaaaaaaaaaaaaaaaaaaaaaaaaaaaaaaaaaaaaaaaaaaaaaaaaaaaaaaaaaaaaaaaaaaaaaaaaaaaaaa
aaaaaaaaaaaaaaaaaaaaaaaaaaaaaaaaaaaaaaaaaaaaaaaaaaaaaaaaaaaaaaaaaaaaaaaaaaaaaaaaaaaaaaaaaaaaaaaaaaaaaaaaaaaaaaaaaaaaaaaaaaaaaaaaaaaaaaaaaaaaaaaaaaaaaa
aaaaaaaaaaaaaaaaaaaaaaaaaaaaaaaaaaaaaaaaaaaaaaaaaaaaaaaaaaaaaaaaaaaaaaaaaaaaaaaaaaaaaaaaaaaaaaaaaaaaaaaaaaaaaaaaaaaaaaaaaaaaaaaaaaaaaaaaaaaaaaaaaaaaaa
aaaaaaaaaaaaaaaaaaaaaaaaaaaaaaaaaaaaaaaaaaaaaaaaaaaaaaaaaaaaaaaaaaaaaaaaaaaaaaaaaaaaaaaaaaaaaaaaaaaaaaaaaaaaaaaaaaaaaaaaaaaaaaaaaaaaaaaaaaaaaaaaaaaaaa
aaaaaaaaaaaaaaaaaaaaaaaaaaaaaaaaaaaaaaaaaaaaaaaaaaaaaaaaaaaaaaaaaaaaaaaaaaaaaaaaaaaaaaaaaaaaaaaaaaaaaaaaaaaaaaaaaaaaaaaaaaaaaaaaaaaaaaaaaaaaaaaaaaaaaa
aaaaaaaaaaaaaaaaaaaaaaaaaaaaaaaaaaaaaaaaaaaaaaaaaaaaaaaaaaaaaaaaaaaaaaaaaaaaaaaaaaaaaaaaaaaaaaaaaaaaaaaaaaaaaaaaaaaaaaaaaaaaaaaaaaaaaaaaaaaaaaaaaaaaaa
aaaaaaaaaaaaaaaaaaaaaaaaaaaaaaaaaaaaaaaaaaaaaaaaaaaaaaaaaaaaaaaaaaaaaaaaaaaaaaaaaaaaaaaaaaaaaaaaaaaaaaaaaaaaaaaaaaaaaaaaaaaaaaaaaaaaaaaaaaaaaaaaaaaaaa
aaaaaaaaaaaaaaaaaaaaaaaaaaaaaaaaaaaaaaaaaaaaaaaaaaaaaaaaaaaaaaaaaaaaaaaaaaaaaaaaaaaaaaaaaaaaaaaaaaaaaaaaaaaaaaaaaaaaaaaaaaaaaaaaaaaaaaaaaaaaaaaaaaaaaa
aaaaaaaaaaaaaaaaaaaaaaaaaaaaaaaaaaaaaaaaaaaaaaaaaaaaaaaaaaaaaaaaaaaaaaaaaaaaaaaaaaaaaaaaaaaaaaaaaaaaaaaaaaaaaaaaaaaaaaaaaaaaaaaaaaaaaaaaaaaaaaaaaaaaaa
aaaaaaaaaaaaaaaaaaaaaaaaaaaaaaaaaaaaaaaaaaaaaaaaaaaaaaaaaaaaaaaaaaaaaaaaaaaaaaaaaaaaaaaaaaaaaaaaaaaaaaaaaaaaaaaaaaaaaaaaaaaaaaaaaaaaaaaaaaaaaaaaaaaaaa
aaaaaaaaaaaaaaaaaaaaaaaaaaaaaaaaaaaaaaaaaaaaaaaaaaaaaaaaaaaaaaaaaaaaaaaaaaaaaaaaaaaaaaaaaaaaaaaaaaaaaaaaaaaaaaaaaaaaaaaaaaaaaaaaaaaaaaaaaaaaaaaaaaaaaa
aaaaaaaaaaaaaaaaaaaaaaaaaaaaaaaaaaaaaaaaaaaaaaaaaaaaaaaaaaaaaaaaaaaaaaaaaaaaaaaaaaaaaaaaaaaaaaaaaaaaaaaaaaaaaaaaaaaaaaaaaaaaaaaaaaaaaaaaaaaaaaaaaaaaaa
aaaaaaaaaaaaaaaaaaaaaaaaaaaaaaaaaaaaaaaaaaaaaaaaaaaaaaaaaaaaaaaaaaaaaaaaaaaaaaaaaaaaaaaaaaaaaaaaaaaaaaaaaaaaaaaaaaaaaaaaaaaaaaaaaaaaaaaaaaaaaaaaaaaaaa
aaaaaaaaaaaaaaaaaaaaaaaaaaaaaaaaaaaaaaaaaaaaaaaaaaaaaaaaaaaaaaaaaaaaaaaaaaaaaaaaaaaaaaaaaaaaaaaaaaaaaaaaaaaaaaaaaaaaaaaaaaaaaaaaaaaaaaaaaaaaaaaaaaaaaa
aaaaaaaaaaaaaaaaaaaaaaaaaaaaaaaaaaaaaaaaaaaaaaaaaaaaaaaaaaaaaaaaaaaaaaaaaaaaaaaaaaaaaaaaaaaaaaaaaaaaaaaaaaaaaaaaaaaaaaaaaaaaaaaaaaaaaaaaaaaaaaaaaaaaaa
aaaaaaaaaaaaaaaaaaaaaaaaaaaaaaaaaaaaaaaaaaaaaaaaaaaaaaaaaaaaaaaaaaaaaaaaaaaaaaaaaaaaaaaaaaaaaaaaaaaaaaaaaaaaaaaaaaaaaaaaaaaaaaaaaaaaaaaaaaaaaaaaaaaaaa
aaaaaaaaaaaaaaaaaaaaaaaaaaaaaaaaaaaaaaaaaaaaaaaaaaaaaaaaaaaaaaaaaaaaaaaaaaaaaaaaaaaaaaaaaaaaaaaaaaaaaaaaaaaaaaaaaaaaaaaaaaaaaaaaaaaaaaaaaaaaaaaaaaaaaa
aaaaaaaaaaaaaaaaaaaaaaaaaaaaaaaaaaaaaaaaaaaaaaaaaaaaaaaaaaaaaaaaaaaaaaaaaaaaaaaaaaaaaaaaaaaaaaaaaaaaaaaaaaaaaaaaaaaaaaaaaaaaaaaaaaaaaaaaaaaaaaaaaaaaaa
aaaaaaaaaaaaaaaaaaaaaaaaaaaaaaaaaaaaaaaaaaaaaaaaaaaaaaaaaaaaaaaaaaaaaaaaaaaaaaaaaaaaaaaaaaaaaaaaaaaaaaaaaaaaaaaaaaaaaaaaaaaaaaaaaaaaaaaaaaaaaaaaaaaaaa
aaaaaaaaaaaaaaaaaaaaaaaaaaaaaaaaaaaaaaaaaaaaaaaaaaaaaaaaaaaaaaaaaaaaaaaaaaaaaaaaaaaaaaaaaaaaaaaaaaaaaaaaaaaaaaaaaaaaaaaaaaaaaaaaaaaaaaaaaaaaaaaaaaaaaa
aaaaaaaaaaaaaaaaaaaaaaaaaaaaaaaaaaaaaaaaaaaaaaaaaaaaaaaaaaaaaaaaaaaaaaaaaaaaaaaaaaaaaaaaaaaaaaaaaaaaaaaaaaaaaaaaaaaaaaaaaaaaaaaaaaaaaaaaaaaaaaaaaaaaaa
aaaaaaaaaaaaaaaaaaaaaaaaaaaaaaaaaaaaaaaaaaaaaaaaaaaaaaaaaaaaaaaaaaaaaaaaaaaaaaaaaaaaaaaaaaaaaaaaaaaaaaaaaaaaaaaaaaaaaaaaaaaaaaaaaaaaaaaaaaaaaaaaaaaaaa
aaaaaaaaaaaaaaaaaaaaaaaaaaaaaaaaaaaaaaaaaaaaaaaaaaaaaaaaaaaaaaaaaaaaaaaaaaaaaaaaaaaaaaaaaaaaaaaaaaaaaaaaaaaaaaaaaaaaaaaaaaaaaaaaaaaaaaaaaaaaaaaaaaaaaa
aaaaaaaaaaaaaaaaaaaaaaaaaaaaaaaaaaaaaaaaaaaaaaaaaaaaaaaaaaaaaaaaaaaaaaaaaaaaaaaaaaaaaaaaaaaaaaaaaaaaaaaaaaaaaaaaaaaaaaaaaaaaaaaaaaaaaaaaaaaaaaaaaaaaaa
aaaaaaaaaaaaaaaaaaaaaaaaaaaaaaaaaaaaaaaaaaaaaaaaaaaaaaaaaaaaaaaaaaaaaaaaaaaaaaaaaaaaaaaaaaaaaaaaaaaaaaaaaaaaaaaaaaaaaaaaaaaaaaaaaaaaaaaaaaaaaaaaaaaaaa
aaaaaaaaaaaaaaaaaaababababababababababababababababababababababababababababababababababababaaaaaaaaaaaaaaaaaaaaaaaaaaaaaaaaaaaaaaaaaaaaaaaaaaaaaaaaaaaa
aaaaaaaaaaaaaaaaaaabacadabaeafafafacagagagahahahacagaiajacahakalacamanaoapacagagagaqacarabaaaaaaaaaaaaaaaaaaaaaaaaaaaaaaaaaaaaaaaaaaaaaaaaaaaaaaaaaaaa
aaaaaaaaaaaaaaaaaaasacacasacafafafacatagagahahahacaiagauacavahalacacawaxaxacagagayacacacabaaaaaaaaaaaaaaaaaaaaaaaaaaaaaaaaaaaaaaaaabababaaaaaaaaaaaaaa
aaaaaaaaaaaaaaaaaaasacacazacafafafacagatagahahahacajauaAacavacacacacahaxaoacayayagacacacabaaaaaaaaaaaaaaaaabababababababababababababaBaCaDaaaaaaaaaaaa
aaaaaaaaaaaaaaaaaaasacacasaEaEaEaEaEaEaEaEaEaEaEaEaEaEaEaEaEaEaEaEaEaEaEaEaEaEaEaEaEaEaEabaaaaaaaaaaaaaaaaabababababababaFaGaHaIaJabaKaCaDaaaaaaaaaaaa
aaaaaaaaaaaaaaaaaaasaLacasaMaMaqacacacacacacacafafafacaEaEacaNaNaNacacafafafacacahaOaOacabaPaPaPaPaPaPaPaPabaQaRabaSaTaUaVaVaVaVaWababaXaaaaaaaaaaaaaa
aaaaaaaaaaaaaaaaaaasacacasaMauaiacacalahavacacafafafacaEaEacaNaNaNacacafafafacacaOaOaOaYaZbababababababababbbcbdbeaVaVbfaVaVaVaVaVbgabaXaaaaaaaaaaaaaa
aaaaaaaaaaaaaaaaaaabbhbiabaubjbjacacahakavacacafafafacaEaEacaNaNaNacacafafafacacaOaOaObkabaPaPaPaPaPaPaPaPabblbmabaVaVaUbnaVboaVaVaVabaXaaaaaaaaaaaaaa
aaaaaaaaaaaaaaaaaaabbpbqababababbrbrabababbrbrabababbsacbsacabababbrbrabababbrbrabababababbtbtbtbtbtbtbtbtababababbubuaUbvbwaVaVaVaWabaXaaaaaaaaaaaaaa
aaaaaaaaaaaaaaaaaaabbhbxabbybzbAacacbBbBbBacacafafafacaEaEacafafafacacagagagacacahahahbCabaPaPaPaPaPaPaPaPabbDaRabaVaVaUbEaVbFaVaVaVbGaXaaaaaaaaaaaaaa
aaaaaaaaaaaaaaaaaaasacacasacacbyacacbBbBbBacacafafafacaEaEacafafafacacagagagacacahahahaYaZbababababababababbbcbdbeaVaVbfaVaVaVaVaVbgabaXaaaaaaaaaaaaaa
aaaaaaaaaaaaaaaaaaasacadasacacacacacbBbBbBacacafafafaqaEaEacafafafacacagagagacacahahahacabaPaPaPaPaPaPaPaPabbHbmabbIbJaUbKbKaVaVbLababaXaaaaaaaaaaaaaa
aaaaaaaaaaaaaaaaaaasadadasbMbMaEaEaEaEaEaEaEaEaEaEaEaEaEaEaEaEaEaEaEaEaEaEaEaEaEaEaEaEaEabaaaaaaaaaaaaaaaaabababababababbNbObPbIbQabaBaCaDaaaaaaaaaaaa
aaaaaaaaaaaaaaaaaaasbRacbSadbTafafacbUbVbVaMaMaMafafafacacavahbWbXbYacafafafacacacbZbZbZabaaaaaaaaaaaaaaaaabababababababababababababaKaCaDaaaaaaaaaaaa
aaaaaaaaaaaaaaaaaaasadacbSacafafafacbVahahaMbzaMafafafacacahakcacbccacafafafaccdaccececeabaaaaaaaaaaaaaaaaaaaaaaaaaaaaaaaaaaaaaaaaabababaaaaaaaaaaaaaa
aaaaaaaaaaaaaaaaaaabadacabcfafafafacbVahahaMcgchafafafacacalavcicjckacafafafaccdaccececeabaaaaaaaaaaaaaaaaaaaaaaaaaaaaaaaaaaaaaaaaaaaaaaaaaaaaaaaaaaaa
aaaaaaaaaaaaaaaaaaababababababababababababababababababababababababababababababababababababaaaaaaaaaaaaaaaaaaaaaaaaaaaaaaaaaaaaaaaaaaaaaaaaaaaaaaaaaaaa
aaaaaaaaaaaaaaaaaaaaaaaaaaaaaaaaaaaaaaaaaaaaaaaaaaaaaaaaaaaaaaaaaaaaaaaaaaaaaaaaaaaaaaaaaaaaaaaaaaaaaaaaaaaaaaaaaaaaaaaaaaaaaaaaaaaaaaaaaaaaaaaaaaaaaa
aaaaaaaaaaaaaaaaaaaaaaaaaaaaaaaaaaaaaaaaaaaaaaaaaaaaaaaaaaaaaaaaaaaaaaaaaaaaaaaaaaaaaaaaaaaaaaaaaaaaaaaaaaaaaaaaaaaaaaaaaaaaaaaaaaaaaaaaaaaaaaaaaaaaaa
aaaaaaaaaaaaaaaaaaaaaaaaaaaaaaaaaaaaaaaaaaaaaaaaaaaaaaaaaaaaaaaaaaaaaaaaaaaaaaaaaaaaaaaaaaaaaaaaaaaaaaaaaaaaaaaaaaaaaaaaaaaaaaaaaaaaaaaaaaaaaaaaaaaaaa
aaaaaaaaaaaaaaaaaaaaaaaaaaaaaaaaaaaaaaaaaaaaaaaaaaaaaaaaaaaaaaaaaaaaaaaaaaaaaaaaaaaaaaaaaaaaaaaaaaaaaaaaaaaaaaaaaaaaaaaaaaaaaaaaaaaaaaaaaaaaaaaaaaaaaa
aaaaaaaaaaaaaaaaaaaaaaaaaaaaaaaaaaaaaaaaaaaaaaaaaaaaaaaaaaaaaaaaaaaaaaaaaaaaaaaaaaaaaaaaaaaaaaaaaaaaaaaaaaaaaaaaaaaaaaaaaaaaaaaaaaaaaaaaaaaaaaaaaaaaaa
aaaaaaaaaaaaaaaaaaaaaaaaaaaaaaaaaaaaaaaaaaaaaaaaaaaaaaaaaaaaaaaaaaaaaaaaaaaaaaaaaaaaaaaaaaaaaaaaaaaaaaaaaaaaaaaaaaaaaaaaaaaaaaaaaaaaaaaaaaaaaaaaaaaaaa
aaaaaaaaaaaaaaaaaaaaaaaaaaaaaaaaaaaaaaaaaaaaaaaaaaaaaaaaaaaaaaaaaaaaaaaaaaaaaaaaaaaaaaaaaaaaaaaaaaaaaaaaaaaaaaaaaaaaaaaaaaaaaaaaaaaaaaaaaaaaaaaaaaaaaa
aaaaaaaaaaaaaaaaaaaaaaaaaaaaaaaaaaaaaaaaaaaaaaaaaaaaaaaaaaaaaaaaaaaaaaaaaaaaaaaaaaaaaaaaaaaaaaaaaaaaaaaaaaaaaaaaaaaaaaaaaaaaaaaaaaaaaaaaaaaaaaaaaaaaaa
aaaaaaaaaaaaaaaaaaaaaaaaaaaaaaaaaaaaaaaaaaaaaaaaaaaaaaaaaaaaaaaaaaaaaaaaaaaaaaaaaaaaaaaaaaaaaaaaaaaaaaaaaaaaaaaaaaaaaaaaaaaaaaaaaaaaaaaaaaaaaaaaaaaaaa
aaaaaaaaaaaaaaaaaaaaaaaaaaaaaaaaaaaaaaaaaaaaaaaaaaaaaaaaaaaaaaaaaaaaaaaaaaaaaaaaaaaaaaaaaaaaaaaaaaaaaaaaaaaaaaaaaaaaaaaaaaaaaaaaaaaaaaaaaaaaaaaaaaaaaa
aaaaaaaaaaaaaaaaaaaaaaaaaaaaaaaaaaaaaaaaaaaaaaaaaaaaaaaaaaaaaaaaaaaaaaaaaaaaaaaaaaaaaaaaaaaaaaaaaaaaaaaaaaaaaaaaaaaaaaaaaaaaaaaaaaaaaaaaaaaaaaaaaaaaaa
aaaaaaaaaaaaaaaaaaaaaaaaaaaaaaaaaaaaaaaaaaaaaaaaaaaaaaaaaaaaaaaaaaaaaaaaaaaaaaaaaaaaaaaaaaaaaaaaaaaaaaaaaaaaaaaaaaaaaaaaaaaaaaaaaaaaaaaaaaaaaaaaaaaaaa
aaaaaaaaaaaaaaaaaaaaaaaaaaaaaaaaaaaaaaaaaaaaaaaaaaaaaaaaaaaaaaaaaaaaaaaaaaaaaaaaaaaaaaaaaaaaaaaaaaaaaaaaaaaaaaaaaaaaaaaaaaaaaaaaaaaaaaaaaaaaaaaaaaaaaa
aaaaaaaaaaaaaaaaaaaaaaaaaaaaaaaaaaaaaaaaaaaaaaaaaaaaaaaaaaaaaaaaaaaaaaaaaaaaaaaaaaaaaaaaaaaaaaaaaaaaaaaaaaaaaaaaaaaaaaaaaaaaaaaaaaaaaaaaaaaaaaaaaaaaaa
aaaaaaaaaaaaaaaaaaaaaaaaaaaaaaaaaaaaaaaaaaaaaaaaaaaaaaaaaaaaaaaaaaaaaaaaaaaaaaaaaaaaaaaaaaaaaaaaaaaaaaaaaaaaaaaaaaaaaaaaaaaaaaaaaaaaaaaaaaaaaaaaaaaaaa
aaaaaaaaaaaaaaaaaaaaaaaaaaaaaaaaaaaaaaaaaaaaaaaaaaaaaaaaaaaaaaaaaaaaaaaaaaaaaaaaaaaaaaaaaaaaaaaaaaaaaaaaaaaaaaaaaaaaaaaaaaaaaaaaaaaaaaaaaaaaaaaaaaaaaa
aaaaaaaaaaaaaaaaaaaaaaaaaaaaaaaaaaaaaaaaaaaaaaaaaaaaaaaaaaaaaaaaaaaaaaaaaaaaaaaaaaaaaaaaaaaaaaaaaaaaaaaaaaaaaaaaaaaaaaaaaaaaaaaaaaaaaaaaaaaaaaaaaaaaaa
aaaaaaaaaaaaaaaaaaaaaaaaaaaaaaaaaaaaaaaaaaaaaaaaaaaaaaaaaaaaaaaaaaaaaaaaaaaaaaaaaaaaaaaaaaaaaaaaaaaaaaaaaaaaaaaaaaaaaaaaaaaaaaaaaaaaaaaaaaaaaaaaaaaaaa
aaaaaaaaaaaaaaaaaaaaaaaaaaaaaaaaaaaaaaaaaaaaaaaaaaaaaaaaaaaaaaaaaaaaaaaaaaaaaaaaaaaaaaaaaaaaaaaaaaaaaaaaaaaaaaaaaaaaaaaaaaaaaaaaaaaaaaaaaaaaaaaaaaaaaa
aaaaaaaaaaaaaaaaaaaaaaaaaaaaaaaaaaaaaaaaaaaaaaaaaaaaaaaaaaaaaaaaaaaaaaaaaaaaaaaaaaaaaaaaaaaaaaaaaaaaaaaaaaaaaaaaaaaaaaaaaaaaaaaaaaaaaaaaaaaaaaaaaaaaaa
aaaaaaaaaaaaaaaaaaaaaaaaaaaaaaaaaaaaaaaaaaaaaaaaaaaaaaaaaaaaaaaaaaaaaaaaaaaaaaaaaaaaaaaaaaaaaaaaaaaaaaaaaaaaaaaaaaaaaaaaaaaaaaaaaaaaaaaaaaaaaaaaaaaaaa
aaaaaaaaaaaaaaaaaaaaaaaaaaaaaaaaaaaaaaaaaaaaaaaaaaaaaaaaaaaaaaaaaaaaaaaaaaaaaaaaaaaaaaaaaaaaaaaaaaaaaaaaaaaaaaaaaaaaaaaaaaaaaaaaaaaaaaaaaaaaaaaaaaaaaa
aaaaaaaaaaaaaaaaaaaaaaaaaaaaaaaaaaaaaaaaaaaaaaaaaaaaaaaaaaaaaaaaaaaaaaaaaaaaaaaaaaaaaaaaaaaaaaaaaaaaaaaaaaaaaaaaaaaaaaaaaaaaaaaaaaaaaaaaaaaaaaaaaaaaaa
aaaaaaaaaaaaaaaaaaaaaaaaaaaaaaaaaaaaaaaaaaaaaaaaaaaaaaaaaaaaaaaaaaaaaaaaaaaaaaaaaaaaaaaaaaaaaaaaaaaaaaaaaaaaaaaaaaaaaaaaaaaaaaaaaaaaaaaaaaaaaaaaaaaaaa
aaaaaaaaaaaaaaaaaaaaaaaaaaaaaaaaaaaaaaaaaaaaaaaaaaaaaaaaaaaaaaaaaaaaaaaaaaaaaaaaaaaaaaaaaaaaaaaaaaaaaaaaaaaaaaaaaaaaaaaaaaaaaaaaaaaaaaaaaaaaaaaaaaaaaa
aaaaaaaaaaaaaaaaaaaaaaaaaaaaaaaaaaaaaaaaaaaaaaaaaaaaaaaaaaaaaaaaaaaaaaaaaaaaaaaaaaaaaaaaaaaaaaaaaaaaaaaaaaaaaaaaaaaaaaaaaaaaaaaaaaaaaaaaaaaaaaaaaaaaaa
aaaaaaaaaaaaaaaaaaaaaaaaaaaaaaaaaaaaaaaaaaaaaaaaaaaaaaaaaaaaaaaaaaaaaaaaaaaaaaaaaaaaaaaaaaaaaaaaaaaaaaaaaaaaaaaaaaaaaaaaaaaaaaaaaaaaaaaaaaaaaaaaaaaaaa
aaaaaaaaaaaaaaaaaaaaaaaaaaaaaaaaaaaaaaaaaaaaaaaaaaaaaaaaaaaaaaaaaaaaaaaaaaaaaaaaaaaaaaaaaaaaaaaaaaaaaaaaaaaaaaaaaaaaaaaaaaaaaaaaaaaaaaaaaaaaaaaaaaaaaa
aaaaaaaaaaaaaaaaaaaaaaaaaaaaaaaaaaaaaaaaaaaaaaaaaaaaaaaaaaaaaaaaaaaaaaaaaaaaaaaaaaaaaaaaaaaaaaaaaaaaaaaaaaaaaaaaaaaaaaaaaaaaaaaaaaaaaaaaaaaaaaaaaaaaaa
"}
